NSU = "countries/lhl_countries/Neo Soviet.txt"
RGD = "countries/lhl_countries/Rosgvardia.txt"
COU = "countries/lhl_countries/Couban.txt"
ACH = "countries/lhl_countries/Cossacks.txt"
KAL = "countries/lhl_countries/Kalmykia.txt" 
CHE = "countries/lhl_countries/Chechnya.txt"
LUH = "countries/lhl_countries/Luhansk.txt"
DON = "countries/lhl_countries/Donetsk.txt"
KHA = "countries/lhl_countries/Kharkiv.txt"
RIS = "countries/lhl_countries/Russian Imperial State.txt"
RST = "countries/lhl_countries/Roman Social Tsardom.txt"
MSC = "countries/lhl_countries/Moscow.txt"
GAZ = "countries/lhl_countries/Gazprom.txt"
NRU = "countries/lhl_countries/Nordic Russia.txt"
RTS = "countries/lhl_countries/Russian Tsardom.txt"
RZD = "countries/lhl_countries/Russian Railways.txt"
STM = "countries/lhl_countries/Sterligov Manor.txt"
SAH = "countries/lhl_countries/Sakhalin.txt"
UST = "countries/lhl_countries/Union state.txt"
BAL = "countries/lhl_countries/Baltica.txt"
LEN = "countries/lhl_countries/Lenoblast.txt"
FRS = "countries/lhl_countries/Free State.txt"
POD = "countries/lhl_countries/Podolie.txt"
TAT = "countries/lhl_countries/Tatarstan.txt"
BSK = "countries/lhl_countries/Bashkortostan.txt"
DNP = "countries/lhl_countries/Dnepropetrovsk.txt"
UPR = "countries/lhl_countries/Ukrainian peasant republic.txt"
NRS = "countries/lhl_countries/Novorossija.txt"
UPA = "countries/lhl_countries/Ukrainian peoples republic.txt"
RNE = "countries/lhl_countries/Russian nationalist republic.txt"
RPR = "countries/lhl_countries/Russian peasant republic.txt"
RWR = "countries/lhl_countries/Russian worker republic.txt"
CHS = "countries/lhl_countries/Chuvashia.txt"
PLP = "countries/lhl_countries/Provisional Poland.txt"
TRG = "countries/lhl_countries/Torgu.txt"
FRG = "countries/lhl_countries/Federal Germany.txt"
SRS = "countries/lhl_countries/Soros Hungary.txt"
RNG = "countries/lhl_countries/Russian National State.txt"
YAK = "countries/lhl_countries/Yakutia.txt"
CPU = "countries/lhl_countries/Conceptual Party Unity.txt"
GOR = "countries/lhl_countries/Anarchy State.txt"
NOD = "countries/lhl_countries/National Liberation Movement.txt"
KRS = "countries/lhl_countries/Krasnoyarsk.txt"
UTO = "countries/lhl_countries/Utopia.txt"
IMT = "countries/lhl_countries/Romanov Empire.txt"
ALT = "countries/lhl_countries/Altai.txt"
NVS = "countries/lhl_countries/Novosibirsk.txt"
TOM = "countries/lhl_countries/Tomsk.txt"
TVA = "countries/lhl_countries/Tuva.txt"
EKB = "countries/lhl_countries/Cartel.txt"
GUL = "countries/lhl_countries/Gulag.txt"
SVE = "countries/lhl_countries/Soviet Vedic Empire.txt"
YGU = "countries/lhl_countries/Uguristan.txt"
CSA = "countries/lhl_countries/Christian States of America.txt"
NAF = "countries/lhl_countries/New Afrika.txt"
UNH = "countries/lhl_countries/Unholy Union.txt"
CUN = "countries/lhl_countries/Celtic Union.txt"
KLP = "countries/lhl_countries/Kleine Prussen.txt"
MOW = "countries/lhl_countries/Morska Wola.txt"
NEA = "countries/lhl_countries/New England.txt"
QUE = "countries/lhl_countries/Quebec.txt"
SIT = "countries/lhl_countries/Little Italy.txt"
VIN = "countries/lhl_countries/Vinland.txt"
LOU = "countries/lhl_countries/Louisiana.txt"
CAL = "countries/lhl_countries/California.txt"
ARI = "countries/lhl_countries/Arizona.txt"
SDE = "countries/lhl_countries/German Sweden.txt"
AUS = "countries/lhl_countries/Austria.txt"
HOL = "countries/lhl_countries/Netherlands.txt"
SLO = "countries/lhl_countries/Slovakia.txt"
CZE = "countries/lhl_countries/Czehia.txt"
NOR = "countries/lhl_countries/Norway.txt"
LUX = "countries/lhl_countries/Luxembourg.txt"
SLV = "countries/lhl_countries/Slovenia.txt"
PRU = "countries/lhl_countries/Prussia.txt"
PDE = "countries/lhl_countries/German Poland.txt"
CAS = "countries/lhl_countries/Cascadia.txt"
ESS = "countries/lhl_countries/Essex.txt"
EAG = "countries/lhl_countries/Freistaat Ostengland.txt"
KNT = "countries/lhl_countries/Kent.txt"
MRC = "countries/lhl_countries/Mercia.txt"
NTH = "countries/lhl_countries/Northumbria.txt"
SUS = "countries/lhl_countries/Sussex.txt"
WES = "countries/lhl_countries/Wessex.txt"
SHA = "countries/lhl_countries/Shanghai.txt"
DEN = "countries/lhl_countries/Denmark.txt"
SWI = "countries/lhl_countries/Switzerland.txt"
GRE = "countries/lhl_countries/Greece.txt"
ALB = "countries/lhl_countries/Albania.txt"
BUL = "countries/lhl_countries/Bulgaria.txt"
MAC = "countries/lhl_countries/Macedonia.txt"
LEB = "countries/lhl_countries/Phoenicia.txt"
EGY = "countries/lhl_countries/Egypt.txt"
ISR = "countries/lhl_countries/Israel.txt"
ASS = "countries/lhl_countries/Assad Syria.txt"
SYR = "countries/lhl_countries/Syria.txt"
TSY = "countries/lhl_countries/Turkish Syria.txt"
IRQ = "countries/lhl_countries/Iraq.txt"
SKD = "countries/lhl_countries/Syrian Kurdistan.txt"
HAR = "countries/lhl_countries/Hashemite Arabia.txt"
SAR = "countrise/lhl_countries/Saudi Arabia.txt"
OMA = "countries/lhl_countries/Oman.txt"
YEM = "countries/lhl_countries/Yemen.txt"
KUW = "countries/lhl_countries/Kuwait.txt"
QAT = "countries/lhl_countries/Qatar.txt"
EMI = "countries/lhl_countries/Emirates.txt"
DRU = "countries/lhl_countries/Druze.txt"
AKS = "countries/lhl_countries/Aksum.txt"
ASB = "countries/lhl_countries/Al-Shabaab.txt"
BSR = "countries/lhl_countries/Beta Israel.txt"
HBS = "countries/lhl_countries/Habashistan.txt"
ICU = "countries/lhl_countries/Islamic Courts Union.txt"
OSO = "countries/lhl_countries/Orthodox State of Amhara and Oromia.txt"
PNT = "countries/lhl_countries/Puntland.txt"
SML = "countries/lhl_countries/Somaliland.txt"
YSM = "countries/lhl_countries/Midiri.txt"
UAS = "countries/lhl_countries/United Arab State.txt"
SPA = "countries/lhl_countries/Spain.txt"
POR = "countries/lhl_countries/Portugal.txt"
ALV = "countries/lhl_countries/Algarve.txt"
AND = "countries/lhl_countries/Andalusia.txt"
NAV = "countries/lhl_countries/Navarra.txt"
BSQ = "countries/lhl_countries/Basque country.txt"
CAT = "countries/lhl_countries/Catalonia.txt"
FRA = "countries/lhl_countries/France.txt"
YUG = "countries/lhl_countries/Yugoslavia.txt"
ITA = "countries/lhl_countries/Italy.txt"
BEL = "countries/lhl_countries/Belgium.txt"
USA = "countries/lhl_countries/United States of Africa.txt"
SAF = "countries/lhl_countries/South Africa.txt"
GUJ = "countries/lhl_countries/Gujarat.txt"
MCH = "countries/lhl_countries/Michigan.txt"
MDW = "countries/lhl_countries/Midwest.txt"
MDG = "countries/lhl_countries/Madagascar.txt"
WAL = "countries/lhl_countries/Wallonie.txt"
CAR = "countries/lhl_countries/Carribean.txt"
AAG = "countries/lhl_countries/Al-Arab Clique.txt"
AIG = "countries/lhl_countries/Al-Islam Clique.txt"
ASG = "countries/lhl_countries/Al-Saadi Clique.txt"
HMG = "countries/lhl_countries/Hannibal Clique.txt"
KHG = "countries/lhl_countries/Khamis Clique.txt"
MBG = "countries/lhl_countries/Moatassem-Billah Clique.txt"
MUG = "countries/lhl_countries/Muhammad Clique.txt"
SOC = "countries/lhl_countries/State of the Church.txt"
LUM = "countries/lhl_countries/L'Unione del Mezzogiorno.txt"
PAD = "countries/lhl_countries/Padania.txt"
PSE = "countries/lhl_countries/The Papal States of Peter III.txt"
PSG = "countries/lhl_countries/The Papal States of Gregory XVII.txt"
PSL = "countries/lhl_countries/The Papal States of Leo XIV.txt"
PSM = "countries/lhl_countries/The Papal States of Michael.txt"
PSP = "countries/lhl_countries/The Papal States of Pius XIII.txt"
PSS = "countries/lhl_countries/The Papal States of Sixtus V.txt"
BYC = "countries/lhl_countries/Blue-Yellow Confederacy.txt"
DBC = "countries/lhl_countries/Dominion of British Columbia.txt"
ATC = "countries/lhl_countries/Atlantic Commonwealth.txt"
PFS = "countries/lhl_countries/Property and Freedom Society.txt"
TIB = "countries/lhl_countries/Tibet.txt"
WRC = "countries/lhl_countries/Welfare Republic of China.txt"
NRC = "countries/lhl_countries/Nationalist Republic of China.txt"
DRC = "countries/lhl_countries/Democratic Republic of China.txt"
HNG = "countries/lhl_countries/Hong Kong.txt"
IND = "countries/lhl_countries/India.txt"
THA = "countries/lhl_countries/Thailand.txt"
BUR = "countries/lhl_countries/Myanmar.txt"
CMB = "countries/lhl_countries/Cambodia.txt"
VIE = "countries/lhl_countries/Vietnam.txt"
PHI = "countries/lhl_countries/Philippines.txt"
AST = "countries/lhl_countries/Australia.txt"
NZL = "countries/lhl_countries/New Zealand.txt"
EAF = "countries/lhl_countries/East African Federation.txt"
ANG = "countries/lhl_countries/Angola.txt"
ZAM = "countries/lhl_countries/Zambia.txt"
MLW = "countries/lhl_countries/Malawi.txt"
ZIM = "countries/lhl_countries/Zimbabwe.txt"
MZB = "countries/lhl_countries/Mozambique.txt"
PNG = "countries/lhl_countries/Papua New Guinea.txt"
GYA = "countries/lhl_countries/Guyana.txt"
BRA = "countries/lhl_countries/Brazil.txt"
PBC = "countries/lhl_countries/Peru–Bolivian Confederation.txt"
MEC = "countries/lhl_countries/Movimiento Etnocacerista.txt"
CHL = "countries/lhl_countries/Chile.txt"
ARG = "countries/lhl_countries/Argentina.txt"
INS = "countries/lhl_countries/Indonesia.txt"
PAR = "countries/lhl_countries/Paraguay.txt"
CCL = "countries/lhl_countries/Chicagoland.txt"
KOA = "countries/lhl_countries/Kingdom of Arkansas.txt"
MBP = "countries/lhl_countries/Midwestern Baptist Pact.txt"
TSE = "countries/lhl_countries/Strangite Empire.txt"
PPR = "countries/lhl_countries/Polish People's Republic.txt"
FSC = "countries/lhl_countries/Free State of Colorado.txt"
ADF = "countries/lhl_countries/Alaska State Defense Force.txt"
WDC = "countries/lhl_countries/Washington Defense Council.txt"
TEX = "countries/lhl_countries/Republic of Texas.txt"
RED = "countries/lhl_countries/American Redoubt.txt"
ARP = "countries/lhl_countries/American Republic.txt"
GRF = "countries/lhl_countries/Shamanov's Realm.txt"
CAS = "countries/lhl_countries/Central Asian Union.txt"
SCO = "countries/lhl_countries/Scotland.txt"
SWB = "countries/lhl_countries/South West England.txt"
WLS = "countries/lhl_countries/Wales.txt"
ULS = "countries/lhl_countries/Ulster.txt"
IRE = "countries/lhl_countries/Ireland.txt"
COL = "countries/lhl_countries/Columbia.txt"
CRB = "countries/lhl_countries/Caribbean Federation.txt"
ECU = "countries/lhl_countries/Ecuador.txt"
HAI = "countries/lhl_countries/Third Empire of Haiti.txt"
MEX = "countries/lhl_countries/Mexican State.txt"
UFC = "countries/lhl_countries/Central American Special Economic Zone.txt"
VEN = "countries/lhl_countries/Venezuela.txt"
ZAP = "countries/lhl_countries/Zapatista Army of National Liberation.txt"
APA = "countries/lhl_countries/All peoples assembly.txt"
MLR = "countries/lhl_countries/Malorossia.txt"